111111
100001
102001
1000W1
111111