R 960		540 


C 25, 31,  40

F 184, 179, 198

NO ./textures/minecraft/chiseled_stone_bricks.xpm
SO ./textures/minecraft/cobblestone.xpm

EA ./textures/minecraft/cracked_stone_bricks.xpm
WE ./textures/minecraft/stone.xpm

S ./sprites/barrel.xpm


11111111
120S0021
10020001
12000021
1111111