R		960		540

C 33, 31, 41

F 184, 179, 198

NO ./textures/minecraft/chiseled_stone_bricks.xpm

SO ./textures/minecraft/cobblestone.xpm

EA ./textures/minecraft/cracked_stone_bricks.xpm

S1 ./sprites/barrel.xpm
S2 ./sprites/greenlight.xpm
S3 ./sprites/pillar.xpm

WE ./textures/minecraft/stone.xpm

        1111111111111111111111111
        1000000000110000000000001
        1011000001110000002000001
        1001003000000000000000001
111111111011000001110000000000001
100000000011000001110111111111111
11110111111111011100000000201
11110111111111011101010010001
11000000110101011100000010031
10002000000000001100000010001
10000000004000001101010010001
11000001110101011111011110N0111
11110111 1110101 101111010001
11111111 1111111 111111111111