R		960		600


C 33, 31, 41

F 184, 179, 198

S2 ./sprites/greenlight.xpm

SO ./textures/minecraft/cobblestone.xpm

EA ./textures/minecraft/cracked_stone_bricks.xpm

NO ./textures/minecraft/chiseled_stone_bricks.xpm

WE ./textures/minecraft/stone.xpm

S1 ./sprites/barrel.xpm

S3 ./sprites/pillar.xpm

11111111111111111111111111111
       1000000040001111111111
11111111001100000000000000001
101100000111 0000010020011001
100100N00000002000300000010011
10110000011110000000000011001
10000000001100000111101111001
111100000000000111000000100011
111101330020300011101010010001
110000001202010111000002100001
10001000000000001100020010001
10000000000000001101010010001
11400000114121411111111111111
11111111111141111111111111111
11111111111111111111111111111